.%%%%%%%%%%%
%oG      Go%
%          %
%          %
%          %
%o   P    o%
%          %
%          %
%          %
%          %
%oG      Go%
%%%%%%%%%%%%