%%%%%%%%%%%%%%%%%%%%
%o   %    .   %   .%
% %% % %%%%%% % %% %
% %              % %
% % %% %%  %% %% % %
%      %G  G%      %
% % %% %%%%%% %% % %
% %      o       % %
% %% % %%%%%% % %% %
%.   %   P    %   o%
%%%%%%%%%%%%%%%%%%%%
